11111111111
10000000101
1000P000101
100000001C1
1000C000101
10000000101
1000E000101
10000000101
11111111111
